actions/add	list-add
actions/appointment	appointment-new
actions/archive-insert-directory	folder-new
actions/archive-insert-directory	../places/folder-add
actions/back	go-previous
actions/bookmark_add	bookmark-new
actions/bookmarks_list_add	bookmark-new
actions/bottom	go-bottom
actions/button_cancel	dialog-cancel
actions/cancel	dialog-cancel
actions/centrejust	format-justify-center
actions/dialog-close	window-close
actions/document-decrypt	../status/object-unlocked
actions/document-encrypt	../status/object-locked
actions/document-open-recent	document-open
actions/document-page-setup	document-print
actions/document-print	../devices/printer
actions/document-save-as	document-save
actions/down	go-down
actions/editclear	edit-clear
actions/editcopy	edit-copy
actions/editcut	edit-cut
actions/editdelete	edit-delete
actions/edit-delete	../places/user-trash
actions/editpaste	edit-paste
actions/exit	application-exit
actions/exit	system-log-out
actions/feed-subscribe	../status/mail-tagged
actions/filefind	edit-find
actions/filenew	document-new
actions/fileopen	document-open
actions/fileprint	document-print
actions/filequickprint	document-print-preview
actions/filesaveas	document-save-as
actions/filesave	document-save
actions/fill-color	format-fill-color
actions/fill-color	view-media-visualization
actions/find	edit-find
actions/finish	go-last
actions/flag	flag-green
actions/flag-green	flag
actions/folder-new	archive-insert-directory
actions/folder_new	folder-new
actions/folder-new	../places/folder-add
actions/format-fill-color	fill-color
actions/format-fill-color	view-media-visualization
actions/forward	go-next
actions/gnome-lockscreen	system-lock-screen
actions/gnome-logout	system-log-out
actions/gnome-run	system-run
actions/gnome-searchtool	system-search
actions/gnome-session-logout	system-log-out
actions/gnome-shutdown	system-shutdown
actions/gnome-stock-mail-fwd	mail-forward
actions/gnome-stock-mail-new	mail-message-new
actions/gnome-stock-mail-rpl	mail-reply-sender
actions/gnome-stock-mail-snd	mail-send
actions/gnome-stock-text-indent	format-indent-more
actions/gnome-stock-text-unindent	format-indent-less
actions/gohome	go-home
actions/gtk-about	help-about
actions/gtk-add	list-add
actions/gtk-bold	format-text-bold
actions/gtk-cancel	dialog-cancel
actions/gtk-cancel	process-stop
actions/gtk-clear	edit-clear
actions/gtk-close	dialog-close
actions/gtk-close	window-close
actions/gtk-copy	edit-copy
actions/gtk-cut	edit-cut
actions/gtk-delete	edit-delete
actions/gtk-edit	../apps/accessories-text-editor
actions/gtk-execute	system-run
actions/gtk-find-and-replace	edit-find-replace
actions/gtk-find	edit-find
actions/gtk-fullscreen	view-fullscreen
actions/gtk-go-back-ltr	go-previous
actions/gtk-go-back-rtl	go-next
actions/gtk-go-down	go-down
actions/gtk-go-forward-ltr	go-next
actions/gtk-go-forward-rtl	go-previous
actions/gtk-goto-bottom	go-bottom
actions/gtk-goto-first-ltr	go-first
actions/gtk-goto-first-rtl	go-last
actions/gtk-goto-last-ltr	go-last
actions/gtk-goto-last-rtl	go-first
actions/gtk-goto-top	go-top
actions/gtk-go-up	go-up
actions/gtk-help	help-contents
actions/gtk-home	go-home
actions/gtk-indent-ltr	format-indent-more
actions/gtk-indent-rtl	format-indent-less
actions/gtk-italic	format-text-italic
actions/gtk-jump-to-ltr	go-jump
actions/gtk-jump-to-rtl	go-jump
actions/gtk-justify-center	format-justify-center
actions/gtk-justify-fill	format-justify-fill
actions/gtk-justify-left	format-justify-left
actions/gtk-justify-right	format-justify-right
actions/gtk-leave-fullscreen	view-restore
actions/gtk-media-forward-ltr	media-seek-forward
actions/gtk-media-forward-rtl	media-seek-backward
actions/gtk-media-next-ltr	media-skip-forward
actions/gtk-media-next-rtl	media-skip-backward
actions/gtk-media-pause	media-playback-pause
actions/gtk-media-play-ltr	media-playback-start
actions/gtk-media-previous-ltr	media-skip-backward
actions/gtk-media-previous-rtl	media-skip-forward
actions/gtk-media-record	media-record
actions/gtk-media-rewind-ltr	media-seek-backward
actions/gtk-media-rewind-rtl	media-seek-forward
actions/gtk-media-stop	media-playback-stop
actions/gtk-new	document-new
actions/gtk-no	dialog-cancel
actions/gtk-ok	dialog-ok
actions/gtk-open	document-open
actions/gtk-paste	edit-paste
actions/gtk-print	document-print
actions/gtk-print-preview	document-print-preview
actions/gtk-properties	document-properties
actions/gtk-quit	application-exit
actions/gtk-redo-ltr	edit-redo
actions/gtk-refresh	view-refresh
actions/gtk-remove	list-remove
actions/gtk-revert-to-saved-ltr	document-revert
actions/gtk-revert-to-saved-rtl	document-revert
actions/gtk-save-as	document-save-as
actions/gtk-save	document-save
actions/gtk-select-all	edit-select-all
actions/gtk-sort-ascending	view-sort-ascending
actions/gtk-sort-descending	view-sort-descending
actions/gtk-spell-check	tools-check-spelling
actions/gtk-stop	process-stop
actions/gtk-strikethrough	format-text-strikethrough
actions/gtk-underline	format-text-underline
actions/gtk-undo-ltr	edit-undo
actions/gtk-unindent-ltr	format-indent-less
actions/gtk-unindent-rtl	format-indent-more
actions/gtk-zoom-100	zoom-original
actions/gtk-zoom-fit	zoom-fit-best
actions/gtk-zoom-in	zoom-in
actions/gtk-zoom-out	zoom-out
actions/help-about	../status/dialog-information
actions/help	help-contents
actions/im-skype	call-start
actions/kfind	system-search
actions/kfm_home	go-home
actions/leftjust	format-justify-left
actions/lock	system-lock-screen
actions/mail_forward	mail-forward
actions/mail-mark-task	../status/mail-task
actions/mail-mark-unread-new	../status/mail-unread-new
actions/mail-message-new	../apps/accessories-text-editor
actions/mail-message-new	gtk-edit
actions/mail_new	mail-message-new
actions/mail-queue	../status/mail-queued
actions/mail_replyall	mail-reply-all
actions/mail_reply	mail-reply-sender
actions/mail_send	mail-send
actions/mail_spam	mail-mark-junk
actions/meeting-attending	../apps/system-users
actions/next	go-next
actions/player_eject	media-eject
actions/player_end	media-skip-forward
actions/player_fwd	media-seek-forward
actions/player_pause	media-playback-pause
actions/player_play	media-playback-start
actions/player_record	media-record
actions/player_rew	media-seek-backward
actions/player_start	media-skip-backward
actions/player_stop	media-playback-stop
actions/previous	go-previous
actions/redhat-home	go-home
actions/redo	edit-redo
actions/reload3	view-refresh
actions/reload_all_tabs	view-refresh
actions/reload_page	view-refresh
actions/reload	view-refresh
actions/remove	list-remove
actions/revert	document-revert
actions/rightjust	format-justify-right
actions/search	system-search
actions/services	../apps/preferences-system-session-services
actions/start	go-first
actions/stock_about	help-about
actions/stock_add-bookmark	bookmark-new
actions/stock_bottom	go-bottom
actions/stock_close	window-close
actions/stock_copy	edit-copy
actions/stock_cut	edit-cut
actions/stock_delete	edit-delete
actions/stock_down	go-down
actions/stock_file-properites	document-properties
actions/stock_first	go-first
actions/stock_fullscreen	view-fullscreen
actions/stock_help-add-bookmark	bookmark-new
actions/stock_help	help-contents
actions/stock_home	go-home
actions/stock_last	go-last
actions/stock_leave-fullscreen	view-restore
actions/stock_left	go-previous
actions/stock_mail-compose	mail-message-new
actions/stock_mail-forward	mail-forward
actions/stock_mail-reply	mail-reply-sender
actions/stock_mail-reply-to-all	mail-reply-all
actions/stock_mail-send	mail-send
actions/stock_mail-send-receive	mail-send-receive
actions/stock_media-fwd	media-seek-forward
actions/stock_media-next	media-skip-forward
actions/stock_media-pause	media-playback-pause
actions/stock_media-play	media-playback-start
actions/stock_media-prev	media-skip-backward
actions/stock_media-rec	media-record
actions/stock_media-rew	media-seek-backward
actions/stock_media-stop	media-playback-stop
actions/stock_new-address-book	address-book-new
actions/stock_new-appointment	appointment-new
actions/stock_new-bcard	contact-new
actions/stock_new-dir	folder-new
actions/stock_new-tab	tab-new
actions/stock_new-text	document-new
actions/stock_new-window	window-new
actions/stock_not-spam	mail-mark-not-junk
actions/stock_paste	edit-paste
actions/stock_print	document-print
actions/stock_print-preview	document-print-preview
actions/stock_print-setup	document-page-setup
actions/stock_properties	document-properties
actions/stock_redo	edit-redo
actions/stock_refresh	view-refresh
actions/stock_right	go-next
actions/stock_save-as	document-save-as
actions/stock_save	document-save
actions/stock_search-and-replace	edit-find-replace
actions/stock_search	edit-find
actions/stock_select-all	edit-select-all
actions/stock_spam	mail-mark-junk
actions/stock_spellcheck	tools-check-spelling
actions/stock_stop	process-stop
actions/stock_text_bold	format-text-bold
actions/stock_text_center	format-justify-center
actions/stock_text_indent	format-indent-more
actions/stock_text_italic	format-text-italic
actions/stock_text_justify	format-justify-fill
actions/stock_text_left	format-justify-left
actions/stock_text_right	format-justify-right
actions/stock_text-strikethrough	format-text-strikethrough
actions/stock_text_underlined	format-text-underline
actions/stock_text_unindent	format-indent-less
actions/stock_top	go-top
actions/stock_undo	edit-undo
actions/stock_up	go-up
actions/stock_zoom-1	zoom-original
actions/stock_zoom-in	zoom-in
actions/stock_zoom-out	zoom-out
actions/stock_zoom-page	zoom-fit-best
actions/stop	process-stop
actions/system-log-out	application-exit
actions/system-search	edit-find
actions/tab_new	tab-new
actions/text_bold	format-text-bold
actions/text_italic	format-text-italic
actions/text_strike	format-text-strikethrough
actions/text_under	format-text-underline
actions/tools-report-bug	../apps/kbugbuster
actions/tools-report-bug	../status/script-error
actions/tools-wizard	../apps/plasmagik
actions/top	go-top
actions/undo	edit-undo
actions/up	go-up
actions/view-bank-account	view-bank
actions/view-bank	view-bank-account
actions/view-categories	view-financial-categories
actions/view-financial-categories	view-categories
actions/viewmag1	zoom-original
actions/viewmagfit	zoom-fit-best
actions/viewmag+	zoom-in
actions/viewmag-	zoom-out
actions/view-media-visualization	fill-color
actions/view-media-visualization	format-fill-color
actions/view-refresh	../status/task-recurring
actions/window-close	dialog-close
actions/window_fullscreen	view-fullscreen
actions/window_new	window-new
actions/window_nofullscreen	view-restore
actions/xfce-system-exit	application-exit
actions/xfce-system-lock	system-lock-screen
actions/zoom-best-fit	zoom-fit-best
animations/gnome-spinner	process-working
animations/gnome-spinner-rest	process-idle
animations/process-idle-kde	../places/start-here-kde
apps/accessibility-directory	preferences-desktop-accessibility
apps/accessories-text-editor	../actions/gtk-edit
apps/access	preferences-desktop-accessibility
apps/arts	multimedia-volume-control
apps/background	preferences-desktop-wallpaper
apps/browser	internet-web-browser
apps/calc	accessories-calculator
apps/config-language	preferences-desktop-locale
apps/config-users	system-users
apps/date	office-calendar
apps/email	internet-mail
apps/file-manager	system-file-manager
apps/file-roller	../mimetypes/package-x-generic
apps/fonts	preferences-desktop-font
apps/gnome-calculator	accessories-calculator
apps/gnome-character-map	accessories-character-map
apps/gnome-help	help-browser
apps/gnome-logout	../actions/application-exit
apps/gnome-mixer	multimedia-volume-control
apps/gnome-monitor	utilities-system-monitor
apps/gnome-remote-desktop	preferences-desktop-remote-desktop
apps/gnome-searchtool	../actions/system-search
apps/gnome-session	preferences-system-session
apps/gnome-settings-accessibility-technologies	preferences-desktop-accessibility
apps/gnome-settings-background	preferences-desktop-wallpaper
apps/gnome-settings-font	preferences-desktop-font
apps/gnome-settings-keybindings	preferences-desktop-keyboard-shortcuts
apps/gnome-settings-theme	preferences-desktop-theme
apps/gnome-shutdown	../actions/application-exit
apps/gnome-terminal	utilities-terminal
apps/gnome-window-manager	preferences-system-windows
apps/gucharmap	accessories-character-map
apps/help-browser	../actions/help-contents
apps/internet-mail	../actions/view-pim-mail
apps/kbugbuster	../actions/tools-report-bug
apps/kbugbuster	../status/script-error
apps/kcalc	accessories-calculator
apps/kcharselect	accessories-character-map
apps/kcmsound	multimedia-volume-control
apps/kde	../animations/process-idle-kde
apps/kde	../places/start-here-kde
apps/kedit	accessories-text-editor
apps/key_bindings	preferences-desktop-keyboard-shortcuts
apps/kfm	system-file-manager
apps/khelpcenter	help-browser
apps/kjournal	../actions/view-pim-journal
apps/knetattach	../actions/archive-insert-directory
apps/knetattach	../actions/folder-new
apps/knetattach	../places/folder-add
apps/konsole	utilities-terminal
apps/krfb	preferences-desktop-remote-desktop
apps/kscreensaver	preferences-desktop-screensaver
apps/ksysguard	utilities-system-monitor
apps/kuser	system-users
apps/locale	preferences-desktop-locale
apps/mail_generic	internet-mail
apps/multimedia	multimedia-volume-control
apps/nautilus-cd-burner	../devices/media-optical
apps/openterm	utilities-terminal
apps/plasmagik	../actions/tools-wizard
apps/preferences-desktop-display	../devices/video-display
apps/preferences-desktop-gaming	../devices/input-gaming
apps/preferences-desktop-launch-feedback	preferences-system-performance
apps/preferences-desktop-mouse	../devices/input-mouse
apps/preferences-desktop-notification-bell	../status/appointment-reminder
apps/preferences-desktop-notification-bell	../status/task-reminder
apps/preferences-system-performance	preferences-desktop-launch-feedback
apps/preferences-system-session-services	../actions/services
apps/proxy-config	preferences-system-network-proxy
apps/proxy	preferences-system-network-proxy
apps/redhat-email	internet-mail
apps/redhat-filemanager	system-file-manager
apps/redhat-web-browser	internet-web-browser
apps/screensaver	preferences-desktop-screensaver
apps/stock_proxy	preferences-system-network-proxy
apps/style	preferences-desktop-theme
apps/susehelpcenter	help-browser
apps/system-config-users	system-users
apps/system-users	../actions/meeting-attending
apps/terminal	utilities-terminal
apps/text-editor	accessories-text-editor
apps/update-manager	system-software-update
apps/volume-knob	multimedia-volume-control
apps/wallpaper	preferences-desktop-wallpaper
apps/web-browser	internet-web-browser
apps/xfcalendar	office-calendar
apps/xfce4-backdrop	preferences-desktop-wallpaper
apps/xfce4-mixer	multimedia-volume-control
apps/xfce4-session	preferences-system-session
apps/xfce4-ui	preferences-desktop-theme
apps/xfce-edit	accessories-text-editor
apps/xfce-filemanager	system-file-manager
apps/xfce-mail	internet-mail
apps/xfce-man	help-browser
apps/xfce-terminal	utilities-terminal
apps/xfwm4	preferences-system-windows
apps/ximian-evolution-calendar	office-calendar
apps/xscreensaver	preferences-desktop-screensaver
apps/zen-icon	system-software-update
categories/applications-education-language	../apps/preferences-desktop-locale
categories/applications-education-mathematics	../apps/preferences-kcalc-constants
categories/applications-games	../devices/input-gaming
categories/applications-games	../../../Nuvola/scalable/categories/applications-games
categories/gnome-applications	applications-office
categories/gnome-control-center	preferences-desktop
categories/gnome-devel	applications-development
categories/gnome-globe	applications-internet
categories/gnome-graphics	applications-graphics
categories/gnome-joystick	applications-games
categories/gnome-multimedia	applications-multimedia
categories/gnome-other	applications-other
categories/gnome-settings	preferences-desktop
categories/gnome-system	applications-system
categories/gnome-util	applications-accessories
categories/gtk-preferences	preferences-desktop
categories/input_devices_settings	preferences-desktop-peripherals
categories/kcontrol	preferences-desktop
categories/package_development	applications-development
categories/package_games	applications-games
categories/package_graphics	applications-graphics
categories/package_multimedia	applications-multimedia
categories/package_network	applications-internet
categories/package_office	applications-office
categories/package_settings	preferences-system
categories/package_system	applications-system
categories/package_utilities	applications-accessories
categories/redhat-accessories	applications-accessories
categories/redhat-games	applications-games
categories/redhat-graphics	applications-graphics
categories/redhat-internet	applications-internet
categories/redhat-office	applications-office
categories/redhat-preferences	preferences-desktop
categories/redhat-programming	applications-development
categories/redhat-sound_video	applications-multimedia
categories/redhat-system_settings	preferences-system
categories/redhat-system_tools	applications-system
categories/stock_internet	applications-internet
categories/xfce4-settings	preferences-desktop
categories/xfce-devel	applications-development
categories/xfce-games	applications-games
categories/xfce-graphics	applications-graphics
categories/xfce-internet	applications-internet
categories/xfce-multimedia	applications-multimedia
categories/xfce-office	applications-office
categories/xfce-system	applications-system
categories/xfce-system-settings	preferences-system
categories/xfce-utils	applications-accessories
devices/3floppy_unmount	media-floppy
devices/camera	camera-photo
devices/camera_unmount	camera-photo
devices/cdrom_unmount	media-optical
devices/cdwriter_unmount	media-optical
devices/chardevice	video-display
devices/display	video-display
devices/drive-cdrom	drive-optical
devices/drive-removable-media	drive-harddisk
devices/dvd_unmount	media-optical
devices/gnome-dev-battery	battery
devices/gnome-dev-cdrom-audio	media-optical
devices/gnome-dev-cdrom	drive-optical
devices/gnome-dev-computer	computer
devices/gnome-dev-disc-cdr	media-optical
devices/gnome-dev-disc-cdrw	media-optical
devices/gnome-dev-disc-dvdram	media-optical
devices/gnome-dev-disc-dvdr	media-optical
devices/gnome-dev-disc-dvdrom	media-optical
devices/gnome-dev-disc-dvdr-plus	media-optical
devices/gnome-dev-disc-dvdrw	media-optical
devices/gnome-dev-dvd	drive-optical
devices/gnome-dev-ethernet	network-wired
devices/gnome-dev-floppy	media-floppy
devices/gnome-dev-harddisk-1394	drive-harddisk
devices/gnome-dev-harddisk	drive-harddisk
devices/gnome-dev-harddisk-usb	drive-harddisk
devices/gnome-dev-ipod	multimedia-player
devices/gnome-dev-keyboard	input-keyboard
devices/gnome-dev-media-cf	media-flash
devices/gnome-dev-media-ms	media-flash
devices/gnome-dev-media-sdmmc	media-flash
devices/gnome-dev-media-sm	media-flash
devices/gnome-dev-mouse-ball	input-mouse
devices/gnome-dev-mouse-optical	input-mouse
devices/gnome-dev-printer	printer
devices/gnome-dev-removable-1394	drive-removable-media
devices/gnome-dev-removable	drive-removable-media
devices/gnome-dev-removable-usb	drive-removable-media
devices/gnome-dev-wavelan	network-wireless
devices/gnome-fs-client	computer
devices/gnome-modem	modem
devices/gnome-stock-mic	audio-input-microphone
devices/gtk-cdrom	media-optical
devices/gtk-floppy	media-floppy
devices/gtk-harddisk	drive-harddisk
devices/harddrive	drive-harddisk
devices/hdd_unmount	drive-harddisk
devices/input-gaming	../apps/preferences-desktop-gaming
devices/input-mouse	../apps/preferences-desktop-mouse
devices/ipod_mount	multimedia-player
devices/joystick	input-gaming
devices/keyboard	input-keyboard
devices/kjobviewer	printer
devices/kxkb	input-keyboard
devices/media-cdrom	media-optical
devices/mouse	input-mouse
devices/network-wireless-connected-100	network-wireless
devices/network-wireless	network-wireless-connected-100
devices/nm-adhoc	network-wireless
devices/nm-device-wired	network-wired
devices/nm-device-wireless	network-wireless
devices/printer1	printer
devices/printer	../actions/document-print
devices/printer-remote	printer
devices/printmgr	printer
devices/stock_cell-phone	phone
devices/stock_mic	audio-input-microphone
devices/stock_printers	printer
devices/system	computer
devices/system-floppy	media-floppy
devices/usbpendrive_unmount	drive-removable-media
devices/video-display	../apps/preferences-desktop-display
devices/xfce4-display	video-display
devices/xfce4-keyboard	input-keyboard
devices/xfce4-mouse	input-mouse
devices/xfce-printer	printer
devices/yast_HD	drive-harddisk
devices/yast_idetude	drive-harddisk
devices/yast_joystick	input-gaming
devices/yast_mouse	input-mouse
devices/yast_printer	printer
devices/yast_soundcard	audio-card
emblems/emblem-danger	../status/task-attention
emblems/emblem-desktop	../places/user-desktop
emblems/emblem-documents	../mimetypes/x-office-document
emblems/emblem-favorite	../actions/rating
emblems/emblem-new	../actions/list-add
emblems/emblem-noread	emblem-unreadable
emblems/emblem-nowrite	emblem-readonly
emblems/emblem-package	../apps/utilities-file-archiver
emblems/emblem-people	../status/meeting-participant-optional
emblems/emblem-personal	../places/user-identity
emblems/emblem-sound	../actions/speaker
emblems/emblem-system	../categories/preferences-system
emblems/emblem-urgent	../status/user-away
emblems/emblem-video	../actions/tool-animator
emotes/stock_smiley-10	face-raspberry
emotes/stock_smiley-11	face-crying
emotes/stock_smiley-13	face-kiss
emotes/stock_smiley-15	face-cool
emotes/stock_smiley-18	face-angel
emotes/stock_smiley-1	face-smile
emotes/stock_smiley-22	face-monkey
emotes/stock_smiley-2	face-smile
emotes/stock_smiley-3	face-wink
emotes/stock_smiley-4	face-sad
emotes/stock_smiley-5	face-surprise
emotes/stock_smiley-6	face-smile-big
emotes/stock_smiley-7	face-smile
emotes/stock_smiley-8	face-plain
mimetypes/application-javascript	application-x-javascript
mimetypes/application-octet-stream	application-x-object
mimetypes/application-octet-stream	application-x-python-bytecode
mimetypes/application-pgp-keys	application-x-pem-key
mimetypes/application-pgp-signature	application-pkcs7-signature
mimetypes/application-pkcs7-mime	application-pgp-keys
mimetypes/application-pkcs7-mime	application-x-pem-key
mimetypes/application-pkcs7-signature	application-pgp-signature
mimetypes/application-postscript	application-x-gzpostscript
mimetypes/application-relaxng	text-vnd.wap.wml
mimetypes/application-relaxng	text-x-dtd
mimetypes/application-relaxng	text-x-xslfo
mimetypes/application-rtf	text-enriched
mimetypes/application-rtf	text-x-authors
mimetypes/application-rtf	text-x-generic
mimetypes/application-rtf	text-x-katefilelist
mimetypes/application-rtf	text-x-nfo
mimetypes/application-vnd.iccprofile	application-x-it87
mimetypes/application-vnd.ms-excel.sheet.binary.macroEnabled.12	application-vnd.ms-excel
mimetypes/application-vnd.ms-excel.sheet.macroEnabled.12	x-office-spreadsheet
mimetypes/application-vnd.ms-excel.template.macroEnabled.12	application-vnd.ms-excel
mimetypes/application-vnd.ms-powerpoint.presentation.macroEnabled.12	x-office-presentation
mimetypes/application-vnd.ms-powerpoint.slideshow.macroEnabled.12	application-vnd.ms-powerpoint
mimetypes/application-vnd.ms-powerpoint.template.macroEnabled.12	application-vnd.ms-powerpoint
mimetypes/application-vnd.ms-word.document.macroEnabled.12	x-office-document
mimetypes/application-vnd.ms-word.template.macroEnabled.12	application-msword
mimetypes/application-vnd.oasis.opendocument.database	libreoffice-oasis-database
mimetypes/application-vnd.oasis.opendocument.drawing	libreoffice-oasis-drawing
mimetypes/application-vnd.oasis.opendocument.drawing-template	libreoffice-oasis-drawing-template
mimetypes/application-vnd.oasis.opendocument.formula	application-x-kformula
mimetypes/application-vnd.oasis.opendocument.formula	libreoffice-oasis-formula
mimetypes/application-vnd.oasis.opendocument.graphics	application-x-tgif
mimetypes/application-vnd.oasis.opendocument.graphics	image-svg+xml
mimetypes/application-vnd.oasis.opendocument.graphics	image-x-xfig
mimetypes/application-vnd.oasis.opendocument.image	application-vnd.stardivision.draw
mimetypes/application-vnd.oasis.opendocument.image	application-vnd.sun.xml.draw
mimetypes/application-vnd.oasis.opendocument.master-document	libreoffice-oasis-master-document
mimetypes/application-vnd.oasis.opendocument.presentation	application-vnd.sun.xml.impress
mimetypes/application-vnd.oasis.opendocument.presentation	application-vnd.sun.xml.impress.png
mimetypes/application-vnd.oasis.opendocument.presentation	libreoffice-oasis-presentation
mimetypes/application-vnd.oasis.opendocument.presentation-template	libreoffice-oasis-presentation-template
mimetypes/application-vnd.oasis.opendocument.spreadsheet	application-vnd.stardivision.calc
mimetypes/application-vnd.oasis.opendocument.spreadsheet	application-vnd.sun.xml.calc
mimetypes/application-vnd.oasis.opendocument.spreadsheet	application-x-applix-spreadsheet
mimetypes/application-vnd.oasis.opendocument.spreadsheet	application-x-gnumeric
mimetypes/application-vnd.oasis.opendocument.spreadsheet	application-x-siag
mimetypes/application-vnd.oasis.opendocument.spreadsheet	libreoffice-oasis-spreadsheet
mimetypes/application-vnd.oasis.opendocument.spreadsheet-template	application-vnd.sun.xml.calc.template
mimetypes/application-vnd.oasis.opendocument.spreadsheet-template	libreoffice-oasis-spreadsheet-template
mimetypes/application-vnd.oasis.opendocument.text	application-vnd.oasis.opendocument.text-master
mimetypes/application-vnd.oasis.opendocument.text	application-x-kword
mimetypes/application-vnd.oasis.opendocument.text	libreoffice-oasis-text
mimetypes/application-vnd.oasis.opendocument.text-master	application-x-kword
mimetypes/application-vnd.oasis.opendocument.text-master	text-rtf
mimetypes/application-vnd.oasis.opendocument.text-template	application-vnd.oasis.opendocument.text-master
mimetypes/application-vnd.oasis.opendocument.text-template	application-vnd.sun.xml.writer.template
mimetypes/application-vnd.oasis.opendocument.text-template	application-x-kword
mimetypes/application-vnd.oasis.opendocument.text-template	libreoffice-oasis-text-template
mimetypes/application-vnd.oasis.opendocument.web-template	libreoffice-oasis-web-template
mimetypes/application-vnd.openxmlformats-officedocument.presentationml.presentation	application-vnd.ms-powerpoint
mimetypes/application-vnd.openxmlformats-officedocument.presentationml.presentation	x-office-presentation
mimetypes/application-vnd.openxmlformats-officedocument.presentationml.slideshow	application-vnd.ms-powerpoint
mimetypes/application-vnd.openxmlformats-officedocument.presentationml.template	application-vnd.ms-powerpoint
mimetypes/application-vnd.openxmlformats-officedocument.presentationml.template	x-office-presentation-template
mimetypes/application-vnd.openxmlformats-officedocument.spreadsheetml.sheet	application-vnd.ms-excel
mimetypes/application-vnd.openxmlformats-officedocument.spreadsheetml.sheet	x-office-spreadsheet
mimetypes/application-vnd.openxmlformats-officedocument.spreadsheetml.template	application-vnd.ms-excel
mimetypes/application-vnd.openxmlformats-officedocument.spreadsheetml.template	x-office-spreadsheet-template
mimetypes/application-vnd.openxmlformats-officedocument.wordprocessingml.document	application-vnd.oasis.opendocument.text
mimetypes/application-vnd.openxmlformats-officedocument.wordprocessingml.document	application-vnd.oasis.opendocument.text-master
mimetypes/application-vnd.openxmlformats-officedocument.wordprocessingml.document	application-x-kword
mimetypes/application-vnd.openxmlformats-officedocument.wordprocessingml.document	x-office-document
mimetypes/application-vnd.openxmlformats-officedocument.wordprocessingml.template	application-msword
mimetypes/application-vnd.openxmlformats-officedocument.wordprocessingml.template	x-office-document-template
mimetypes/application-vnd.rn-realmedia	application-x-mplayer2
mimetypes/application-vnd.rn-realmedia	application-x-shockwave-flash
mimetypes/application-vnd.rn-realmedia	audio-vnd.rn-realvideo
mimetypes/application-vnd.rn-realmedia	audio-vn.rn-realmedia
mimetypes/application-vnd.rn-realmedia	audio-vn.rn-realvideo
mimetypes/application-vnd.rn-realmedia	video-x-generic
mimetypes/application-vnd.stardivision.calc	application-vnd.sun.xml.calc
mimetypes/application-vnd.stardivision.calc	application-x-applix-spreadsheet
mimetypes/application-vnd.stardivision.calc	application-x-gnumeric
mimetypes/application-vnd.stardivision.calc	application-x-siag
mimetypes/application-vnd.stardivision.draw	application-vnd.oasis.opendocument.image
mimetypes/application-vnd.stardivision.draw	application-vnd.sun.xml.draw
mimetypes/application-vnd.stardivision.mail	message
mimetypes/application-vnd.stardivision.mail	message-rfc822
mimetypes/application-vnd.stardivision.mail	message-x-gnu-rmail
mimetypes/application-vnd.stardivision.math	application-vnd.oasis.opendocument.formula
mimetypes/application-vnd.stardivision.math	application-x-kformula
mimetypes/application-vnd.sun.xml.calc	application-vnd.stardivision.calc
mimetypes/application-vnd.sun.xml.calc	application-x-applix-spreadsheet
mimetypes/application-vnd.sun.xml.calc	application-x-gnumeric
mimetypes/application-vnd.sun.xml.calc	application-x-siag
mimetypes/application-vnd.sun.xml.calc.template	application-vnd.oasis.opendocument.spreadsheet-template
mimetypes/application-vnd.sun.xml.calc.template	application-vnd.sun.xml.calc
mimetypes/application-vnd.sun.xml.calc.template	application-x-gnumeric
mimetypes/application-vnd.sun.xml.draw	application-vnd.oasis.opendocument.image
mimetypes/application-vnd.sun.xml.draw	application-vnd.stardivision.draw
mimetypes/application-vnd.sun.xml.impress	application-vnd.oasis.opendocument.presentation
mimetypes/application-vnd.sun.xml.impress.png	application-vnd.oasis.opendocument.presentation
mimetypes/application-vnd.sun.xml.impress.template	application-vnd.oasis.opendocument.presentation-template
mimetypes/application-vnd.sun.xml.impress.template.png	application-vnd.oasis.opendocument.presentation-template
mimetypes/application-vnd.sun.xml.math	application-vnd.oasis.opendocument.formula
mimetypes/application-vnd.sun.xml.math	application-x-kformula
mimetypes/application-vnd.sun.xml.writer	application-vnd.oasis.opendocument.text-master
mimetypes/application-vnd.sun.xml.writer	application-x-kword
mimetypes/application-vnd.sun.xml.writer.global	application-vnd.oasis.opendocument.text-master
mimetypes/application-vnd.sun.xml.writer.global	application-x-kword
mimetypes/application-vnd.sun.xml.writer.png	application-x-kword
mimetypes/application-x-7z-compressed	application-x-ace
mimetypes/application-x-7z-compressed	application-x-arj
mimetypes/application-x-7z-compressed	application-x-lha
mimetypes/application-x-abiword	application-vnd.oasis.opendocument.text
mimetypes/application-x-abiword	application-vnd.oasis.opendocument.text-master
mimetypes/application-x-abiword	application-x-kword
mimetypes/application-x-ace	application-x-arj
mimetypes/application-x-ace	application-x-lha
mimetypes/application-x-applix-spreadsheet	application-vnd.stardivision.calc
mimetypes/application-x-applix-spreadsheet	application-vnd.sun.xml.calc
mimetypes/application-x-applix-spreadsheet	application-x-gnumeric
mimetypes/application-x-applix-spreadsheet	application-x-siag
mimetypes/application-x-applix-word	application-vnd.oasis.opendocument.text-master
mimetypes/application-x-applix-word	text-rtf
mimetypes/application-x-ar	application-x-cpio
mimetypes/application-x-ar	application-x-tar
mimetypes/application-x-arc	application-x-ace
mimetypes/application-x-arc	application-x-arj
mimetypes/application-x-arc	application-x-lha
mimetypes/application-x-archive	application-x-ar
mimetypes/application-x-archive	application-x-cpio
mimetypes/application-x-archive	application-x-tar
mimetypes/application-x-arj	application-x-ace
mimetypes/application-x-arj	application-x-lha
mimetypes/application-x-awk	text-x-script
mimetypes/application-x-bzdvi	application-x-gzdvi
mimetypes/application-x-bzip	application-x-lzop
mimetypes/application-x-bzip	application-x-pak
mimetypes/application-x-bzip-compressed-tar	application-x-ace
mimetypes/application-x-bzip-compressed-tar	application-x-arj
mimetypes/application-x-bzip-compressed-tar	application-x-lha
mimetypes/application-x-cda	text-xmcd
mimetypes/application-x-compress	application-x-bzip
mimetypes/application-x-compress	application-x-lzop
mimetypes/application-x-compress	application-x-pak
mimetypes/application-x-cpio	application-x-ar
mimetypes/application-x-cpio	application-x-tar
mimetypes/application-x-desktop	application-x-executable
mimetypes/application-x-egon	image-x-generic
mimetypes/application-x-egon	video-x-mng
mimetypes/application-x-executable	application-x-desktop
mimetypes/application-x-executable-script	application-x-ms-dos-executable
mimetypes/application-x-font-afm	application-x-font-type1
mimetypes/application-x-font-bdf	application-x-font-pcf
mimetypes/application-x-font-bdf	application-x-font-snf
mimetypes/application-x-font-pcf	application-x-font-bdf
mimetypes/application-x-font-pcf	application-x-font-snf
mimetypes/application-x-font-snf	application-x-font-bdf
mimetypes/application-x-font-snf	application-x-font-pcf
mimetypes/application-x-font-type1	application-x-font-afm
mimetypes/application-x-gnumeric	application-vnd.stardivision.calc
mimetypes/application-x-gnumeric	application-vnd.sun.xml.calc
mimetypes/application-x-gnumeric	application-x-applix-spreadsheet
mimetypes/application-x-gnumeric	application-x-siag
mimetypes/application-x-gzip	application-x-bzip
mimetypes/application-x-gzip	application-x-lzop
mimetypes/application-x-gzip	application-x-pak
mimetypes/application-xhtml+xml	application-xml
mimetypes/application-x-it87	application-vnd.iccprofile
mimetypes/application-x-java-applet	application-x-java
mimetypes/application-x-java-applet	text-x-java
mimetypes/application-x-java	application-x-java-applet
mimetypes/application-x-javascript	application-javascript
mimetypes/application-x-java	text-x-java
mimetypes/application-x-kexiproject-sqlite2	application-vnd.oasis.opendocument.database
mimetypes/application-x-kexiproject-sqlite3	application-vnd.oasis.opendocument.database
mimetypes/application-x-kexiproject-sqlite3	application-x-kexiproject-sqlite2
mimetypes/application-x-kexiproject-sqlite	application-vnd.oasis.opendocument.database
mimetypes/application-x-kexiproject-sqlite	application-x-kexiproject-sqlite2
mimetypes/application-x-kformula	application-vnd.oasis.opendocument.formula
mimetypes/application-x-kontour	application-x-tgif
mimetypes/application-x-kontour	image-svg+xml
mimetypes/application-x-kontour	image-x-xfig
mimetypes/application-x-kword	application-vnd.oasis.opendocument.text
mimetypes/application-x-kword	application-vnd.oasis.opendocument.text-master
mimetypes/application-x-lha	application-x-ace
mimetypes/application-x-lha	application-x-arj
mimetypes/application-x-lzma-compressed-tar	application-x-ar
mimetypes/application-x-lzma-compressed-tar	application-x-cpio
mimetypes/application-x-lzma-compressed-tar	application-x-tar
mimetypes/application-x-lzop	application-x-bzip
mimetypes/application-x-lzop	application-x-pak
mimetypes/application-x-m4	text-x-makefile
mimetypes/application-x-mimearchive	message
mimetypes/application-x-mimearchive	message-rfc822
mimetypes/application-x-mimearchive	message-x-gnu-rmail
mimetypes/application-xml	application-xhtml+xml
mimetypes/application-x-mplayer2	application-x-shockwave-flash
mimetypes/application-x-mplayer2	audio-vnd.rn-realvideo
mimetypes/application-x-mplayer2	audio-vn.rn-realmedia
mimetypes/application-x-mplayer2	audio-vn.rn-realvideo
mimetypes/application-x-mplayer2	video-x-generic
mimetypes/application-x-ms-dos-executable	application-x-executable-script
mimetypes/application-x-mswinurl	application-xslt+xml
mimetypes/application-x-mswinurl	text-html
mimetypes/application-x-object	application-x-python-bytecode
mimetypes/application-x-pak	application-x-bzip
mimetypes/application-x-pak	application-x-lzop
mimetypes/application-x-pem-key	application-pgp-keys
mimetypes/application-x-python-bytecode	application-x-object
mimetypes/application-x-quattropro	application-vnd.stardivision.calc
mimetypes/application-x-quattropro	application-vnd.sun.xml.calc
mimetypes/application-x-quattropro	application-x-applix-spreadsheet
mimetypes/application-x-quattropro	application-x-gnumeric
mimetypes/application-x-quattropro	application-x-siag
mimetypes/application-x-rar	application-x-ace
mimetypes/application-x-rar	application-x-arj
mimetypes/application-x-rar	application-x-lha
mimetypes/application-x-sharedlib	application-x-object
mimetypes/application-x-sharedlib	application-x-python-bytecode
mimetypes/application-x-shellscript	application-x-awk
mimetypes/application-x-shellscript	text-x-script
mimetypes/application-x-shockwave-flash	audio-vnd.rn-realvideo
mimetypes/application-x-shockwave-flash	audio-vn.rn-realmedia
mimetypes/application-x-siag	application-vnd.stardivision.calc
mimetypes/application-x-siag	application-vnd.sun.xml.calc
mimetypes/application-x-siag	application-x-applix-spreadsheet
mimetypes/application-x-siag	application-x-gnumeric
mimetypes/application-xslt+xml	text-html
mimetypes/application-x-smb-server	../places/network-server
mimetypes/application-x-smb-workgroup	../places/network-workgroup
mimetypes/application-x-sqlite2	application-vnd.oasis.opendocument.database
mimetypes/application-x-sqlite2	application-x-kexiproject-sqlite2
mimetypes/application-x-sqlite3	application-vnd.oasis.opendocument.database
mimetypes/application-x-sqlite3	application-x-kexiproject-sqlite2
mimetypes/application-x-srt	application-x-srtrip
mimetypes/application-x-srtrip	application-x-srt
mimetypes/application-x-srtrip	text-plain
mimetypes/application-x-srtrip	text-x-changelog
mimetypes/application-x-srt	text-plain
mimetypes/application-x-srt	text-x-changelog
mimetypes/application-x-subrip	application-x-srtrip
mimetypes/application-x-subrip	text-plain
mimetypes/application-x-subrip	text-x-changelog
mimetypes/application-x-tar	application-x-ar
mimetypes/application-x-tar	application-x-cpio
mimetypes/application-x-tarz	application-x-ace
mimetypes/application-x-tarz	application-x-arj
mimetypes/application-x-tarz	application-x-lha
mimetypes/application-x-tgif	image-svg+xml
mimetypes/application-x-tgif	image-x-xfig
mimetypes/application-x-troff-man	text-troff
mimetypes/application-x-tzo	application-x-ace
mimetypes/application-x-tzo	application-x-arj
mimetypes/application-x-tzo	application-x-lha
mimetypes/application-x-wmf	application-x-tgif
mimetypes/application-x-wmf	image-svg+xml
mimetypes/application-x-wmf	image-x-xfig
mimetypes/application-x-zoo	application-x-ace
mimetypes/application-x-zoo	application-x-arj
mimetypes/application-x-zoo	application-x-lha
mimetypes/application-zip	application-x-ace
mimetypes/application-zip	application-x-arj
mimetypes/application-zip	application-x-lha
mimetypes/ascii	text-x-generic
mimetypes/audio-ac3	audio-x-adpcm
mimetypes/audio-ac3	audio-x-flac
mimetypes/audio-ac3	audio-x-monkey
mimetypes/audio-midi	audio-prs.sid
mimetypes/audio-vnd.rn-realvideo	application-x-mplayer2
mimetypes/audio-vnd.rn-realvideo	application-x-shockwave-flash
mimetypes/audio-vnd.rn-realvideo	audio-vn.rn-realmedia
mimetypes/audio-vnd.rn-realvideo	audio-vn.rn-realvideo
mimetypes/audio-vnd.rn-realvideo	video-x-generic
mimetypes/audio-vn.rn-realmedia	application-x-mplayer2
mimetypes/audio-vn.rn-realmedia	application-x-shockwave-flash
mimetypes/audio-vn.rn-realmedia	audio-vnd.rn-realvideo
mimetypes/audio-vn.rn-realmedia	audio-vn.rn-realvideo
mimetypes/audio-vn.rn-realmedia	video-x-generic
mimetypes/audio-vn.rn-realvideo	application-x-mplayer2
mimetypes/audio-vn.rn-realvideo	audio-vnd.rn-realvideo
mimetypes/audio-vn.rn-realvideo	audio-vn.rn-realmedia
mimetypes/audio-vn.rn-realvideo	video-x-generic
mimetypes/audio-x-adpcm	audio-ac3
mimetypes/audio-x-adpcm	audio-x-monkey
mimetypes/audio-x-adpcm	audio-x-wav
mimetypes/audio-x-aiff	audio-ac3
mimetypes/audio-x-aiff	audio-x-adpcm
mimetypes/audio-x-aiff	audio-x-monkey
mimetypes/audio-x-aiff	audio-x-wav
mimetypes/audio-x-flac	audio-ac3
mimetypes/audio-x-flac	audio-x-adpcm
mimetypes/audio-x-flac	audio-x-flac+ogg
mimetypes/audio-x-flac	audio-x-monkey
mimetypes/audio-x-flac+ogg	audio-ac3
mimetypes/audio-x-flac+ogg	audio-x-adpcm
mimetypes/audio-x-flac+ogg	audio-x-flac
mimetypes/audio-x-flac+ogg	audio-x-monkey
mimetypes/audio-x-generic	audio-ac3
mimetypes/audio-x-generic	audio-x-adpcm
mimetypes/audio-x-generic	audio-x-flac
mimetypes/audio-x-generic	audio-x-flac+ogg
mimetypes/audio-x-generic	audio-x-monkey
mimetypes/audio-x-monkey	audio-ac3
mimetypes/audio-x-monkey	audio-x-adpcm
mimetypes/audio-x-monkey	audio-x-flac
mimetypes/audio-x-monkey	audio-x-flac+ogg
mimetypes/audio-x-wav	audio-ac3
mimetypes/audio-x-wav	audio-x-adpcm
mimetypes/audio-x-wav	audio-x-monkey
mimetypes/binary	application-x-executable
mimetypes/contents2	x-office-address-book
mimetypes/deb	package-x-generic
mimetypes/djvu	image-vnd.djvu
mimetypes/document	x-office-document
mimetypes/empty	text-x-generic
mimetypes/encrypted	application-pgp-keys
mimetypes/encrypted	application-x-pem-key
mimetypes/exec	application-x-executable
mimetypes/folder_tar	package-x-generic
mimetypes/font_bitmap	font-x-generic
mimetypes/font	font-x-generic
mimetypes/font_truetype	font-x-generic
mimetypes/font_type1	font-x-generic
mimetypes/gnome-fs-executable	application-x-executable
mimetypes/gnome-fs-regular	text-x-preview
mimetypes/gnome-mime-application-magicpoint	x-office-presentation
mimetypes/gnome-mime-application-msword	x-office-document
mimetypes/gnome-mime-application-ogg	audio-x-generic
mimetypes/gnome-mime-application-pdf	x-office-document
mimetypes/gnome-mime-application-postscript	x-office-document
mimetypes/gnome-mime-application-rtf	x-office-document
mimetypes/gnome-mime-application-vnd.lotus-1-2-3	x-office-spreadsheet
mimetypes/gnome-mime-application-vnd.ms-excel	x-office-spreadsheet
mimetypes/gnome-mime-application-vnd.ms-powerpoint	x-office-presentation
mimetypes/gnome-mime-application-vnd.oasis.opendocument.graphics-template	x-office-drawing-template
mimetypes/gnome-mime-application-vnd.oasis.opendocument.graphics	x-office-drawing
mimetypes/gnome-mime-application-vnd.oasis.opendocument.image	x-office-drawing
mimetypes/gnome-mime-application-vnd.oasis.opendocument.presentation-template	x-office-presentation-template
mimetypes/gnome-mime-application-vnd.oasis.opendocument.presentation	x-office-presentation
mimetypes/gnome-mime-application-vnd.oasis.opendocument.spreadsheet-template	x-office-spreadsheet-template
mimetypes/gnome-mime-application-vnd.oasis.opendocument.spreadsheet	x-office-spreadsheet
mimetypes/gnome-mime-application-vnd.oasis.opendocument.text-template	x-office-document-template
mimetypes/gnome-mime-application-vnd.oasis.opendocument.text-web	text-html
mimetypes/gnome-mime-application-vnd.oasis.opendocument.text	x-office-document
mimetypes/gnome-mime-application-vnd.rn-realmedia-secure	video-x-generic
mimetypes/gnome-mime-application-vnd.rn-realmedia-vbr	video-x-generic
mimetypes/gnome-mime-application-vnd.rn-realmedia	video-x-generic
mimetypes/gnome-mime-application-vnd.stardivision.calc	x-office-spreadsheet
mimetypes/gnome-mime-application-vnd.stardivision.impress	x-office-presentation
mimetypes/gnome-mime-application-vnd.stardivision.writer	x-office-document
mimetypes/gnome-mime-application-vnd.sun.xml.calc.template	x-office-spreadsheet-template
mimetypes/gnome-mime-application-vnd.sun.xml.calc	x-office-spreadsheet
mimetypes/gnome-mime-application-vnd.sun.xml.draw.template	x-office-drawing-template
mimetypes/gnome-mime-application-vnd.sun.xml.draw	x-office-drawing
mimetypes/gnome-mime-application-vnd.sun.xml.impress.template	x-office-presentation-template
mimetypes/gnome-mime-application-vnd.sun.xml.impress	x-office-presentation
mimetypes/gnome-mime-application-vnd.sun.xml.writer.template	x-office-document-template
mimetypes/gnome-mime-application-vnd.sun.xml.writer	x-office-document
mimetypes/gnome-mime-application-wordperfect	x-office-document
mimetypes/gnome-mime-application-x-7z-compressed	package-x-generic
mimetypes/gnome-mime-application-x-abiword	x-office-document
mimetypes/gnome-mime-application-x-applix-spreadsheet	x-office-spreadsheet
mimetypes/gnome-mime-application-x-applix-word	x-office-document
mimetypes/gnome-mime-application-x-archive	package-x-generic
mimetypes/gnome-mime-application-x-arj	package-x-generic
mimetypes/gnome-mime-application-x-bzip-compressed-tar	package-x-generic
mimetypes/gnome-mime-application-x-bzip	package-x-generic
mimetypes/gnome-mime-application-x-compressed-tar	gnome-mime-application-x-gzip
mimetypes/gnome-mime-application-x-compressed-tar	gnome-mime-application-x-tar
mimetypes/gnome-mime-application-x-compressed-tar	package-x-generic
mimetypes/gnome-mime-application-x-compress	package-x-generic
mimetypes/gnome-mime-application-x-cpio-compressed	package-x-generic
mimetypes/gnome-mime-application-x-cpio	package-x-generic
mimetypes/gnome-mime-application-x-deb	package-x-generic
mimetypes/gnome-mime-application-x-dvi	x-office-document
mimetypes/gnome-mime-application-x-executable	application-x-executable
mimetypes/gnome-mime-application-x-font-afm	font-x-generic
mimetypes/gnome-mime-application-x-font-bdf	font-x-generic
mimetypes/gnome-mime-application-x-font-linux-psf	font-x-generic
mimetypes/gnome-mime-application-x-font-pcf	font-x-generic
mimetypes/gnome-mime-application-x-font-sunos-news	font-x-generic
mimetypes/gnome-mime-application-x-font-ttf	font-x-generic
mimetypes/gnome-mime-application-x-gnumeric	x-office-spreadsheet
mimetypes/gnome-mime-application-x-gzip	package-x-generic
mimetypes/gnome-mime-application-x-gzpostscript	x-office-document
mimetypes/gnome-mime-application-xhtml+xml	text-html
mimetypes/gnome-mime-application-x-jar	package-x-generic
mimetypes/gnome-mime-application-x-java-byte-code	gnome-mime-text-x-java
mimetypes/gnome-mime-application-x-killustrator	image-x-generic
mimetypes/gnome-mime-application-x-kpresenter	x-office-presentation
mimetypes/gnome-mime-application-x-kspread	x-office-spreadsheet
mimetypes/gnome-mime-application-x-kword	x-office-document
mimetypes/gnome-mime-application-x-lha	package-x-generic
mimetypes/gnome-mime-application-x-lhz	package-x-generic
mimetypes/gnome-mime-application-x-lzma-compressed-tar	package-x-generic
mimetypes/gnome-mime-application-x-lzma	package-x-generic
mimetypes/gnome-mime-application-x-ms-dos-executable	application-x-executable
mimetypes/gnome-mime-application-x-perl	text-x-script
mimetypes/gnome-mime-application-x-php	text-html
mimetypes/gnome-mime-application-x-python-bytecode	text-x-script
mimetypes/gnome-mime-application-x-rar	package-x-generic
mimetypes/gnome-mime-application-x-rpm	package-x-generic
mimetypes/gnome-mime-application-x-scribus	x-office-document
mimetypes/gnome-mime-application-x-shellscript	text-x-script
mimetypes/gnome-mime-application-x-shockwave-flash	video-x-generic
mimetypes/gnome-mime-application-x-stuffit	package-x-generic
mimetypes/gnome-mime-application-x-tar	package-x-generic
mimetypes/gnome-mime-application-x-tarz	package-x-generic
mimetypes/gnome-mime-application-x-tex	x-office-document
mimetypes/gnome-mime-application-zip	package-x-generic
mimetypes/gnome-mime-audio	audio-x-generic
mimetypes/gnome-mime-image	image-x-generic
mimetypes/gnome-mime-text-html	text-html
mimetypes/gnome-mime-text	text-x-generic
mimetypes/gnome-mime-text-vnd.wap.wml	text-html
mimetypes/gnome-mime-text-x-authors	gnome-mime-text-x-readme
mimetypes/gnome-mime-text-x-copying	gnome-mime-text-x-readme
mimetypes/gnome-mime-text-x-csh	text-x-script
mimetypes/gnome-mime-text-x-c++src	gnome-mime-text-x-csrc
mimetypes/gnome-mime-text-x-patch	gnome-mime-application-x-reject
mimetypes/gnome-mime-text-x-python	text-x-script
mimetypes/gnome-mime-text-x-sh	text-x-script
mimetypes/gnome-mime-text-x-tex	gnome-mime-application-x-tex
mimetypes/gnome-mime-text-x-vcalendar	x-office-calendar
mimetypes/gnome-mime-text-x-vcard	x-office-address-book
mimetypes/gnome-mime-text-x-zsh	text-x-script
mimetypes/gnome-mime-video	video-x-generic
mimetypes/gnome-mime-x-font-afm	font-x-generic
mimetypes/gnome-package	package-x-generic
mimetypes/gtk-file	text-x-preview
mimetypes/html	text-html
mimetypes/image	image-x-generic
mimetypes/image-svg+xml	application-x-tgif
mimetypes/image-svg+xml-compressed	application-x-tgif
mimetypes/image-svg+xml-compressed	image-svg+xml
mimetypes/image-svg+xml-compressed	image-x-xfig
mimetypes/image-svg+xml	image-x-xfig
mimetypes/image-x-adobe-dng	application-x-egon
mimetypes/image-x-adobe-dng	video-x-mng
mimetypes/image-x-generic	application-x-egon
mimetypes/image-x-generic	video-x-mng
mimetypes/image-x-xfig	application-x-tgif
mimetypes/image-x-xfig	image-svg+xml
mimetypes/inode-directory	../places/folder
mimetypes/kpresenter_kpr	x-office-presentation
mimetypes/mail-message-new-list	message
mimetypes/mail-message-new-list	message-x-gnu-rmail
mimetypes/message	message-rfc822
mimetypes/message	message-x-gnu-rmail
mimetypes/message-rfc822	message
mimetypes/message-rfc822	message-x-gnu-rmail
mimetypes/message-x-gnu-rmail	message
mimetypes/message-x-gnu-rmail	message-rfc822
mimetypes/mime_ascii	text-x-generic
mimetypes/misc	text-x-generic
mimetypes/package_editors	text-x-generic
mimetypes/package	package-x-generic
mimetypes/package_wordprocessing	x-office-document
mimetypes/package-x-generic	application-x-ar
mimetypes/package-x-generic	application-x-cpio
mimetypes/package-x-generic	application-x-tar
mimetypes/plan	x-office-calendar
mimetypes/rpm	package-x-generic
mimetypes/shellscript	text-x-script
mimetypes/sound	audio-x-generic
mimetypes/spreadsheet	x-office-spreadsheet
mimetypes/stock_addressbook	x-office-address-book
mimetypes/stock_calendar	x-office-calendar
mimetypes/stock_certificate	application-certificate
mimetypes/stock_script	text-x-script
mimetypes/tar	package-x-generic
mimetypes/template_source	text-x-generic-template
mimetypes/text-calendar	text-vcalendar
mimetypes/text-calendar	x-office-calendar
mimetypes/text-csharp	text-x-csharp
mimetypes/text-css	text-plain
mimetypes/text-css	text-x-changelog
mimetypes/text-csv	application-vnd.stardivision.calc
mimetypes/text-csv	application-vnd.sun.xml.calc
mimetypes/text-csv	application-x-gnumeric
mimetypes/text-enriched	application-rtf
mimetypes/text-enriched	text-x-authors
mimetypes/text-enriched	text-x-generic
mimetypes/text-enriched	text-x-katefilelist
mimetypes/text-enriched	text-x-nfo
mimetypes/text-html	application-x-mswinurl
mimetypes/text-html	application-xslt+xml
mimetypes/text-plain	text-x-changelog
mimetypes/text-rdf	text-rdf+xml
mimetypes/text-rdf+xml	text-rdf
mimetypes/text-rtf	application-vnd.oasis.opendocument.text-master
mimetypes/text-rtf	application-x-applix-word
mimetypes/text-sgml	text-x-authors
mimetypes/text-sgml	text-x-generic
mimetypes/text-sgml	text-x-katefilelist
mimetypes/text-sgml	text-x-nfo
mimetypes/text-troff	application-x-troff-man
mimetypes/text-vcalendar	text-calendar
mimetypes/text-vcalendar	x-office-calendar
mimetypes/text-vnd.abc	audio-ac3
mimetypes/text-vnd.abc	audio-x-adpcm
mimetypes/text-vnd.abc	audio-x-flac
mimetypes/text-vnd.abc	audio-x-flac+ogg
mimetypes/text-vnd.abc	audio-x-monkey
mimetypes/text-vnd.wap.wml	application-relaxng
mimetypes/text-vnd.wap.wml	text-x-dtd
mimetypes/text-vnd.wap.wml	text-x-xslfo
mimetypes/text-x-authors	text-x-generic
mimetypes/text-x-authors	text-x-katefilelist
mimetypes/text-x-authors	text-x-nfo
mimetypes/text-x-bibtex	text-x-tex
mimetypes/text-x-changelog	application-x-srtrip
mimetypes/text-x-changelog	text-plain
mimetypes/text-x-chdr	text-x-objchdr
mimetypes/text-x-chdr	x-office-document
mimetypes/text-x-cmake	text-x-authors
mimetypes/text-x-cmake	text-x-generic
mimetypes/text-x-cmake	text-x-katefilelist
mimetypes/text-x-cmake	text-x-nfo
mimetypes/text-x-copying	text-x-authors
mimetypes/text-x-copying	text-x-generic
mimetypes/text-x-copying	text-x-katefilelist
mimetypes/text-x-copying	text-x-nfo
mimetypes/text-x-csharp	text-csharp
mimetypes/text-x-csrc	text-x-objcsrc
mimetypes/text-x-dtd	application-relaxng
mimetypes/text-x-dtd	text-vnd.wap.wml
mimetypes/text-x-dtd	text-x-xslfo
mimetypes/text-x-generic-template	text-x-generic
mimetypes/text-x-generic	text-sgml
mimetypes/text-x-generic	text-x-authors
mimetypes/text-x-generic	text-x-katefilelist
mimetypes/text-x-generic	text-x-nfo
mimetypes/text-x-install	text-x-authors
mimetypes/text-x-install	text-x-generic
mimetypes/text-x-install	text-x-katefilelist
mimetypes/text-x-install	text-x-nfo
mimetypes/text-x-java	application-x-java-applet
mimetypes/text-x-katefilelist	text-x-authors
mimetypes/text-x-katefilelist	text-x-generic
mimetypes/text-x-log	text-x-authors
mimetypes/text-x-log	text-x-generic
mimetypes/text-x-log	text-x-katefilelist
mimetypes/text-x-log	text-x-nfo
mimetypes/text-x-makefile	application-x-m4
mimetypes/text-xmcd	application-x-cda
mimetypes/text-xml	application-xhtml+xml
mimetypes/text-xml	application-xml
mimetypes/text-x-nfo	text-sgml
mimetypes/text-x-nfo	text-x-authors
mimetypes/text-x-nfo	text-x-generic
mimetypes/text-x-nfo	text-x-katefilelist
mimetypes/text-x-objchdr	text-x-chdr
mimetypes/text-x-objcsrc	text-x-csrc
mimetypes/text-x-plain	application-x-srtrip
mimetypes/text-x-plain	text-x-changelog
mimetypes/text-x-readme	text-x-authors
mimetypes/text-x-readme	text-x-generic
mimetypes/text-x-readme	text-x-katefilelist
mimetypes/text-x-readme	text-x-nfo
mimetypes/text-x-script	application-x-awk
mimetypes/text-x-tex	text-x-bibtex
mimetypes/text-x-vcard	text-x-ldif
mimetypes/text-x-xslfo	application-relaxng
mimetypes/text-x-xslfo	text-vnd.wap.wml
mimetypes/text-x-xslfo	text-x-dtd
mimetypes/tgz	package-x-generic
mimetypes/txt2	text-x-generic
mimetypes/txt	text-x-generic
mimetypes/unknown	text-x-generic
mimetypes/uri-mms	application-x-shockwave-flash
mimetypes/uri-mms	audio-vnd.rn-realvideo
mimetypes/uri-mms	audio-vn.rn-realmedia
mimetypes/uri-mmst	application-x-shockwave-flash
mimetypes/uri-mmst	audio-vnd.rn-realvideo
mimetypes/uri-mmst	audio-vn.rn-realmedia
mimetypes/uri-mmst	uri-mms
mimetypes/uri-mmst	uri-mmsu
mimetypes/uri-mmst	uri-rtspu
mimetypes/uri-mmsu	application-x-shockwave-flash
mimetypes/uri-mmsu	audio-vnd.rn-realvideo
mimetypes/uri-mmsu	audio-vn.rn-realmedia
mimetypes/uri-mms	uri-mmsu
mimetypes/uri-mms	uri-rtspu
mimetypes/uri-mmsu	uri-mms
mimetypes/uri-mmsu	uri-rtspu
mimetypes/uri-pnm	application-x-shockwave-flash
mimetypes/uri-pnm	audio-vnd.rn-realvideo
mimetypes/uri-pnm	audio-vn.rn-realmedia
mimetypes/uri-pnm	uri-mms
mimetypes/uri-pnm	uri-mmsu
mimetypes/uri-pnm	uri-rtspu
mimetypes/uri-rtspt	application-x-shockwave-flash
mimetypes/uri-rtspt	audio-vnd.rn-realvideo
mimetypes/uri-rtspt	audio-vn.rn-realmedia
mimetypes/uri-rtspt	uri-mms
mimetypes/uri-rtspt	uri-mmsu
mimetypes/uri-rtspt	uri-rtspu
mimetypes/uri-rtspu	application-x-shockwave-flash
mimetypes/uri-rtspu	audio-vnd.rn-realvideo
mimetypes/uri-rtspu	audio-vn.rn-realmedia
mimetypes/uri-rtspu	uri-mms
mimetypes/uri-rtspu	uri-mmsu
mimetypes/vcalendar	x-office-calendar
mimetypes/vcard	x-office-address-book
mimetypes/video	video-x-generic
mimetypes/video-x-generic	application-x-mplayer2
mimetypes/video-x-generic	application-x-shockwave-flash
mimetypes/video-x-generic	audio-vnd.rn-realvideo
mimetypes/video-x-generic	audio-vn.rn-realmedia
mimetypes/video-x-generic	audio-vn.rn-realvideo
mimetypes/video-x-mng	application-x-egon
mimetypes/video-x-mng	image-x-generic
mimetypes/wordprocessing	x-office-document
mimetypes/www	text-html
mimetypes/x-office-calendar	../apps/evolution-calendar
mimetypes/x-office-calendar	text-calendar
mimetypes/x-office-calendar	text-vcalendar
mimetypes/x-office-document	text-x-chdr
mimetypes/x-office-presentation	application-vnd.oasis.opendocument.presentation
mimetypes/x-office-spreadsheet	application-vnd.stardivision.calc
mimetypes/x-office-spreadsheet	application-vnd.sun.xml.calc
mimetypes/x-office-spreadsheet	application-x-applix-spreadsheet
mimetypes/x-office-spreadsheet	application-x-gnumeric
mimetypes/x-office-spreadsheet	application-x-siag
mimetypes/zip	package-x-generic
places/application-x-gnome-saved-search	folder-saved-search
places/bookmarks	favorites
places/desktop	user-desktop
places/distributor-logo	start-here
places/emptytrash	user-trash
places/favorites	bookmarks
places/folder-add	../actions/folder-new
places/folder-download	folder-downloads
places/folder_home	user-home
places/folder-home	user-home
places/folder-images	folder-image
places/folder	../mimetypes/inode-directory
places/folder-music	folder-sound
places/folder-open	folder-grey
places/folder-pictures	folder-image
places/folder-publicshare	folder-remote
places/folder-remote-ftp	folder-remote
places/folder-remote-nfs	folder-remote
places/folder-remote-smb	folder-remote
places/folder-remote-ssh	folder-remote
places/folder-videos	folder-video
places/gnome-fs-desktop	user-desktop
places/gnome-fs-directory	folder
places/gnome-fs-ftp	folder-remote
places/gnome-fs-ftp	folder-remote-ftp
places/gnome-fs-home	user-home
places/gnome-fs-network	network-workgroup
places/gnome-fs-nfs	folder-remote
places/gnome-fs-server	network-server
places/gnome-fs-share	folder-remote
places/gnome-fs-smb	folder-remote
places/gnome-fs-smb	folder-remote-smb
places/gnome-fs-ssh	folder-remote
places/gnome-fs-ssh	folder-remote-ssh
places/gnome-fs-trash-empty	user-trash
places/gnome-main-menu	start-here
places/gnome-mime-x-directory-nfs-server	network-server
places/gnome-mime-x-directory-smb-server	network-server
places/gnome-mime-x-directory-smb-share	folder-remote
places/gnome-mime-x-directory-smb-share	folder-remote-smb
places/gnome-mime-x-directory-smb-workgroup	network-workgroup
places/gnome-stock-trash	user-trash
places/gtk-directory	folder
places/gtk-network	network-workgroup
places/inode-directory	folder
places/mail-outbox	mail-folder-outbox
places/network	folder-remote
places/network_local	network-workgroup
places/network	network-workgroup
places/network-server	../mimetypes/application-x-smb-server
places/network-workgroup	../mimetypes/application-x-smb-workgroup
places/novell-button	start-here
places/redhat-network-server	network-server
places/server	network-server
places/start-here-kde	../animations/process-idle-kde
places/start-here-kde	../apps/kde
places/stock_folder	folder
places/trashcan_empty	user-trash
places/user-bookmarks	bookmarks
places/user-bookmarks	folder-favorites
places/user-images	folder-image
places/user-pictures	folder-image
places/user-share	folder-remote
places/xfce-trash_empty	user-trash
status/appointment-recurring	../actions/view-refresh
status/appointment-recurring	task-recurring
status/appointment-reminder	../apps/preferences-desktop-notification-bell
status/appointment-reminder	task-reminder
status/connect_creating	network-transmit-receive
status/connect_established	network-idle
status/connect_no	network-offline
status/dialog-information	../actions/help-about
status/edittrash	user-trash-full
status/error	dialog-error
status/folder-open	folder-drag-accept
status/folder_open	folder-open
status/folder-open	folder-visiting
status/folder-visiting	folder-drag-accept
status/gnome-dev-wavelan-encrypted	network-wireless-encrypted
status/gnome-fs-directory-accept	folder-drag-accept
status/gnome-fs-directory-visiting	folder-visiting
status/gnome-fs-loading-icon	image-loading
status/gnome-fs-trash-full	user-trash-full
status/gnome-netstatus-disconn	network-offline
status/gnome-netstatus-error	network-error
status/gnome-netstatus-idle	network-idle
status/gnome-netstatus-rx	network-receive
status/gnome-netstatus-tx	network-transmit
status/gnome-netstatus-txrx	network-transmit-receive
status/gnome-stock-trash-full	user-trash-full
status/gtk-dialog-authentication	dialog-password
status/gtk-dialog-error	dialog-error
status/gtk-dialog-info	dialog-information
status/gtk-dialog-question	dialog-question
status/gtk-dialog-warning	dialog-warning
status/gtk-directory	folder-open
status/gtk-missing-image	image-missing
status/image-missing	../mimetypes/text-x-preview
status/important	dialog-warning
status/info	dialog-information
status/mail-queued	../actions/mail-queue
status/mail-tagged	../actions/feed-subscribe
status/mail-task	../actions/mail-mark-task
status/mail-unread-new	../actions/mail-mark-unread-new
status/messagebox_critical	dialog-error
status/messagebox_info	dialog-information
status/messagebox_warning	dialog-warning
status/nm-no-connection	network-offline
status/object-locked	../actions/document-encrypt
status/object-unlocked	../actions/document-decrypt
status/script-error	../actions/tools-report-bug
status/script-error	../apps/kbugbuster
status/stock_appointment-reminder	appointment-soon
status/stock_appointment-reminder-excl	appointment-missed
status/stock_attach	mail-attachment
status/stock_dialog-error	dialog-error
status/stock_dialog-info	dialog-information
status/stock_dialog-question	dialog-question
status/stock_dialog-warning	dialog-warning
status/stock_lock-broken	security-low
status/stock_lock-ok	security-high
status/stock_lock-open	security-low
status/stock_lock	security-medium
status/stock_mail-open	mail-read
status/stock_mail-replied	mail-replied
status/stock_mail-unread	mail-unread
status/stock_open	folder-open
status/stock_repeat	media-playlist-repeat
status/stock_shuffle	media-playlist-shuffle
status/stock_trash_full	user-trash-full
status/stock_volume-0	audio-volume-low
status/stock_volume	audio-volume-high
status/stock_volume-max	audio-volume-high
status/stock_volume-med	audio-volume-medium
status/stock_volume-min	audio-volume-low
status/stock_volume-mute	audio-volume-muted
status/stock_weather-cloudy	weather-overcast
status/stock_weather-few-clouds	weather-few-clouds
status/stock_weather-fog	weather-fog
status/stock_weather-night-clear	weather-clear-night
status/stock_weather-night-few-clouds	weather-few-clouds-night
status/stock_weather-showers	weather-showers
status/stock_weather-snow	weather-snow
status/stock_weather-storm	weather-storm
status/stock_weather-sunny	weather-clear
status/sunny	weather-clear
status/task-recurring	../actions/view-refresh
status/task-reminder	appointment-reminder
status/task-reminder	../apps/preferences-desktop-notification-bell
status/trashcan_full	user-trash-full
status/xfce-trash_full	user-trash-full
